Ostfalia
An Interactive Fiction by Fadi Dokmak, Amina Mustafi, Ibrahim Karaki
Release 1 / Serial number 180426 / Inform 7 build 6M62 (I6/v6.33 lib 6/12N) SD

Westkorridor Abschnitt 1
Der Eingangsbereich des Ostflügels. Im Norden ist ein Zwischenraum der ins Herren WC und zum Raum 060 führt. Südöstlich der Laborraum 051 und südwestlich der Raum 052. Östlich ist der Westkorridor Abschnitt 2.

>R051, R052, R053, R054, R055, R056, R057, R058, R059, R060, R071, R072, R073, R074, R075, R076, R077, R078, R079, R080, R081, R082, R083, R084, R085 are rooms.
You seem to want to talk to someone, but I can't see whom.

* * *

Ostfalia
An Interactive Fiction by Fadi Dokmak, Amina Mustafi, Ibrahim Karaki
Release 1 / Serial number 180426 / Inform 7 build 6M62 (I6/v6.33 lib 6/12N) SD

Westkorridor Abschnitt 1
Der Eingangsbereich des Ostflügels. Im Norden ist ein Zwischenraum der ins Herren WC und zum Raum 060 führt. Südöstlich der Laborraum 051 und südwestlich der Raum 052. Östlich ist der Westkorridor Abschnitt 2.

>go east
Ostkorridor 1
Hier ist der Ostkorridor 1. Von hier aus kann man nördlich in die Damentoilette und östlich in den Ostkorridor 2.

>go Ostkorridor 2
You can't see any such thing.

>go east
Ostkorridor 2
Hier ist der Ostkorridor 2. Nordwestlich ist der Fahrstuhl und nordöstlich ist der Raum 023. Südwestlich befindet sich der Raum 020, südlich der Raum 029 und südöstlich der Raum 028b. Westlich vom Ostkorridor 2 befindet sich der Ostkorridor 1 und östlich vom Ostkorridor 2 ist der Ostkorridor 3

* * *

>go east
Ostkorridor 1
Hier ist der Ostkorridor 1. Von hier aus kann man nördlich in die Damentoilette und östlich in den Ostkorridor 2.

>go east
Ostkorridor 2
Hier ist der Ostkorridor 2. Nordwestlich ist der Fahrstuhl und nordöstlich ist der Raum 023. Südwestlich befindet sich der Raum 020, südlich der Raum 029 und südöstlich der Raum 028b. Westlich vom Ostkorridor 2 befindet sich der Ostkorridor 1 und östlich vom Ostkorridor 2 ist der Ostkorridor 3

You can see Fahrstuhl_door here.

>do northwest
That's not a verb I recognise.

>go northwest
Fahrstuhl
Hier befindet sich ein Fahrstuhl. Nördlich vom Fahrstuhl gelangt man in den Raum Barriere, der ein barrierefreier Zugang für den Fahrstuhl darstellt. Südlich gelangt man auf den Ostkorridor 2. Mit dem Befehl go up gelangt man in den Dachgschoss.

>go up
Aufzug Dachgeschoss
Hier befindet sich der Fahrstuhl. Südwestlich vom Fahrstuhl ist das Östliche Treppenhaus. Südlich von diesem Raum ist der Seminar Raum 224. Mit dem Befehl go down gelangt man in den Erdgeschoss.

>go southwest
Treppenhaus Ost Dachgeschosss
Treppenhaus Ost. Westlich von diesem Raum befinden sich der Leerer Raum Dachgeschoss und der Lernbereich Dachgeshoss. Östlich befinden sich die Aufzug Dachgeschoss und Seminar Raum 224 Räume

>go west
Lernbereich Dachgeshoss
Lernbereich Dachgeshoss südlich im SuedKorridor. In diesem Raum können Studenten lernen. Sowohl westlich als auch östlich befindet sich ein Treppenhaus. Im norden befindet sich ein leerer Raum

>go west
Treppenhaus West Dachgeschosss
Treppenhaus West. Wesltich von diesem Raum befindet sich der Hörsaal 252. Östlich vom Treppenhaus befinden sich der Raum Lernbereich Dachgeshoss.

>go west
Raum 252
Ein Hörsaal westlich im SuedKorridor. Östlich von diesem Raum ist der Westliche Treppenhaus Westlich von hier befindet sich der Korridor 6 Dachgeschoss..

You can see Geist here.

* * *

>go east
Ostkorridor 2
Hier ist der Ostkorridor 2. Nordwestlich ist der Fahrstuhl und nordöstlich ist der Raum 023. Südwestlich befindet sich der Raum 020, südlich der Raum 029 und südöstlich der Raum 028b. Westlich vom Ostkorridor 2 befindet sich der Ostkorridor 1 und östlich vom Ostkorridor 2 ist der Ostkorridor 3

You can see Fahrstuhl_door here.

>go north
Die Aufzugtür ist geschlossen

>push Erdgeschoss Fahrstuhltürknopf
You can't see any such thing.

>push Fahrstuhl knopf
Die Aufzugtür öffnet sich

* * *

>go east
Ostkorridor 2
Hier ist der Ostkorridor 2. Nordwestlich ist der Fahrstuhl und nordöstlich ist der Raum 023. Südwestlich befindet sich der Raum 020, südlich der Raum 029 und südöstlich der Raum 028b. Westlich vom Ostkorridor 2 befindet sich der Ostkorridor 1 und östlich vom Ostkorridor 2 ist der Ostkorridor 3

You can see Fahrstuhl_door here.

>go northeast
Raum 023
Hier befindet sich ein Raum mit Kaffeeautomaten. Nördlich von dem Raum 023 befindet sich ein leerer Raum und südlich gelangt man auf den Ostkorridor 2.

>go southwest
Ostkorridor 2
Hier ist der Ostkorridor 2. Nordwestlich ist der Fahrstuhl und nordöstlich ist der Raum 023. Südwestlich befindet sich der Raum 020, südlich der Raum 029 und südöstlich der Raum 028b. Westlich vom Ostkorridor 2 befindet sich der Ostkorridor 1 und östlich vom Ostkorridor 2 ist der Ostkorridor 3

>go northwest
Fahrstuhl
Hier befindet sich ein Fahrstuhl. Nördlich vom Fahrstuhl gelangt man in den Raum Barriere, der ein barrierefreier Zugang für den Fahrstuhl darstellt. Südlich gelangt man auf den Ostkorridor 2. Mit dem Befehl go up gelangt man in den Dachgschoss.

>go up
Aufzug Dachgeschoss
Hier befindet sich der Fahrstuhl. Westlich vom Fahrstuhl ist das Östliche Treppenhaus. Südlich von diesem Raum ist der Seminar Raum 224. Mit dem Befehl go down gelangt man in den Erdgeschoss.

>go west
You can't go that way.

>go west
You can't go that way.

>go east
Raum 223
Hörsaal östlich im SuedKorridor. Südlich von diesem Raum sind die Räume Aufzug Dachgeschoss und Seminar Raum 224

>go west
Aufzug Dachgeschoss
Hier befindet sich der Fahrstuhl. Westlich vom Fahrstuhl ist das Östliche Treppenhaus. Südlich von diesem Raum ist der Seminar Raum 224. Mit dem Befehl go down gelangt man in den Erdgeschoss.

>go southwest
Treppenhaus Ost Dachgeschosss
Treppenhaus Ost. Westlich von diesem Raum befinden sich der Leerer Raum Dachgeschoss und der Lernbereich Dachgeshoss. Östlich befinden sich die Aufzug Dachgeschoss und Seminar Raum 224 Räume

* * *

>go west
Raum 252
Ein Hörsaal westlich im SuedKorridor. Östlich von diesem Raum ist der Westliche Treppenhaus Westlich von hier befindet sich der Korridor 6 Dachgeschoss..

You can see Geist here.

>look
Raum 252
Ein Hörsaal westlich im SuedKorridor. Östlich von diesem Raum ist der Westliche Treppenhaus Westlich von hier befindet sich der Korridor 6 Dachgeschoss..

You can see Geist here.

* * *

>go east
Ostkorridor 2
Hier ist der Ostkorridor 2. Nordwestlich ist der Fahrstuhl und nordöstlich ist der Raum 023. Südwestlich befindet sich der Raum 020, südlich der Raum 029 und südöstlich der Raum 028b. Westlich vom Ostkorridor 2 befindet sich der Ostkorridor 1 und östlich vom Ostkorridor 2 ist der Ostkorridor 3

You can see Fahrstuhl_door here.

>go northwest
Fahrstuhl
Hier befindet sich ein Fahrstuhl. Nördlich vom Fahrstuhl gelangt man in den Raum Barriere, der ein barrierefreier Zugang für den Fahrstuhl darstellt. Südlich gelangt man auf den Ostkorridor 2. Mit dem Befehl go up gelangt man in den Dachgschoss.

>go southwest
You can't go that way.

>go up
Aufzug Dachgeschoss
Hier befindet sich der Fahrstuhl. Südwestlich vom Fahrstuhl ist das Östliche Treppenhaus. Südlich von diesem Raum ist der Seminar Raum 224. Mit dem Befehl go down gelangt man in den Erdgeschoss.

* * *

>go west
Raum 252
Ein Hörsaal westlich im SuedKorridor. Östlich von diesem Raum ist der Westliche Treppenhaus Westlich von hier befindet sich der Korridor 6 Dachgeschoss..

You can see Geist here.

>go east
Treppenhaus West Dachgeschosss
Treppenhaus West. Wesltich von diesem Raum befindet sich der Hörsaal 252. Östlich vom Treppenhaus befinden sich der Raum Lernbereich Dachgeshoss.

>go west
Raum 252
Ein Hörsaal westlich im SuedKorridor. Östlich von diesem Raum ist der Westliche Treppenhaus Westlich von hier befindet sich der Korridor 6 Dachgeschoss..

You can see Geist here.

* * *

>go up
Aufzug Dachgeschoss
Hier befindet sich der Fahrstuhl. Südwestlich vom Fahrstuhl ist das Östliche Treppenhaus. Südlich von diesem Raum ist der Seminar Raum 224. Mit dem Befehl go down gelangt man in den Erdgeschoss.

>go down
Fahrstuhl
Hier befindet sich ein Fahrstuhl. Nördlich vom Fahrstuhl gelangt man in den Raum Barriere, der ein barrierefreier Zugang für den Fahrstuhl darstellt. Südlich gelangt man auf den Ostkorridor 2. Mit dem Befehl go up gelangt man in den Dachgschoss.

* * *

>go east
Treppenhaus West Dachgeschosss
Treppenhaus West. Wesltich von diesem Raum befindet sich der Hörsaal 252. Östlich vom Treppenhaus befinden sich der Raum Lernbereich Dachgeshoss.

>look
Treppenhaus West Dachgeschosss
Treppenhaus West. Wesltich von diesem Raum befindet sich der Hörsaal 252. Östlich vom Treppenhaus befinden sich der Raum Lernbereich Dachgeshoss.

>go west
Raum 252
Ein Hörsaal westlich im SuedKorridor. Östlich von diesem Raum ist der Westliche Treppenhaus Westlich von hier befindet sich der Korridor 6 Dachgeschoss..

You can see Geist here.

>go south
You can't go that way.

>go east
Treppenhaus West Dachgeschosss
Treppenhaus West. Wesltich von diesem Raum befindet sich der Hörsaal 252. Östlich vom Treppenhaus befinden sich der Raum Lernbereich Dachgeshoss.

* * *

>look
Raum 252
Ein Hörsaal westlich im SuedKorridor. Östlich von diesem Raum ist der Westliche Treppenhaus Westlich von hier befindet sich der Korridor 6 Dachgeschoss..

You can see Geist here.

>speak
I didn't understand that sentence.

>show
(Geist Geist)
(first taking Geist)
I don't suppose Geist would care for that.

>talk to geist
That's not a verb I recognise.

>speack with geist
That's not a verb I recognise.

>go to geist
You can't see any such thing.

>show
(Geist Geist)
(first taking Geist)
I don't suppose Geist would care for that.

>geist
That's not a verb I recognise.

>ask geist
(for Geist)
(Geist first taking Geist)
Geist has better things to do.

>ask geist about
I didn't understand that sentence.

>talk geist
That's not a verb I recognise.

>tell geist
I didn't understand that sentence.

>tell geist he is a looser
I didn't understand that sentence.

>ask geist
(for Geist)
(Geist first taking Geist)
Geist has better things to do.

* * *

>go east
Ostkorridor 2
Hier ist der Ostkorridor 2. Nordwestlich ist der Fahrstuhl und nordöstlich ist der Raum 023. Südwestlich befindet sich der Raum 020, südlich der Raum 029 und südöstlich der Raum 028b. Westlich vom Ostkorridor 2 befindet sich der Ostkorridor 1 und östlich vom Ostkorridor 2 ist der Ostkorridor 3

You can see Fahrstuhl_door here.

>go soutwest
You can't see any such thing.

>go southwest
Raum 030
Hier ist ein Büro. Westlich von Raum 030 kann man in den Raum 029/zum Sekretariat.

* * *

>go east
Ostkorridor 2
Hier ist der Ostkorridor 2. Nordwestlich ist der Fahrstuhl und nordöstlich ist der Raum 023. Südwestlich befindet sich der Raum 020, südlich der Raum 029 und südöstlich der Raum 028b. Westlich vom Ostkorridor 2 befindet sich der Ostkorridor 1 und östlich vom Ostkorridor 2 ist der Ostkorridor 3

You can see Fahrstuhl_door here.

>ho northwest
That's not a verb I recognise.

>go northwest
Fahrstuhl
Hier befindet sich ein Fahrstuhl. Nördlich vom Fahrstuhl gelangt man in den Raum Barriere, der ein barrierefreier Zugang für den Fahrstuhl darstellt. Südlich gelangt man auf den Ostkorridor 2. Mit dem Befehl go up gelangt man in den Dachgschoss.

>go south
You can't go that way.

>go up
Aufzug Dachgeschoss
Hier befindet sich der Fahrstuhl. Südwestlich vom Fahrstuhl ist das Östliche Treppenhaus. Südlich von diesem Raum ist der Seminar Raum 224. Mit dem Befehl go down gelangt man in den Erdgeschoss.

* * *

Ostfalia
An Interactive Fiction by Fadi Dokmak, Amina Mustafi, Ibrahim Karaki
Release 1 / Serial number 180426 / Inform 7 build 6M62 (I6/v6.33 lib 6/12N) SD

Westkorridor Abschnitt 1
Der Eingangsbereich des Ostflügels. Im Norden ist ein Zwischenraum der ins Herren WC und zum Raum 060 führt. Südöstlich der Laborraum 051 und südwestlich der Raum 052. Östlich ist der Westkorridor Abschnitt 2.

>go north
Zwischenraum A
Ein kleiner Zwischenraum. Weiter im Norden ist der Raum 060 und im Osten ist das Herren WC. Im Süden geht zum Westkorridor Abschnitt 1.

You can see Geist here.

>go east
Herren WC
Ein Herren WC. Es befindet sich im Eingangbereich des Westflügels. Südlich ist der Westkorridor Abschnitt 1.

* * *

>go north
Zwischenraum A
Ein kleiner Zwischenraum. Weiter im Norden ist der Raum 060 und im Osten ist das Herren WC. Im Süden geht zum Westkorridor Abschnitt 1.

You can see Geist here.

>go south
Westkorridor Abschnitt 1
Der Eingangsbereich des Ostflügels. Im Norden ist ein Zwischenraum der ins Herren WC und zum Raum 060 führt. Südöstlich der Laborraum 051 und südwestlich der Raum 052. Östlich ist der Westkorridor Abschnitt 2.

>go west
Westkorridor Abschnitt 2
Westkorridor Abschnitt 2. Hier finden sich zwei Räume und ein Labor. Nordöstlich ist der Raum 059 und nordwestlich ist Raum 058. Im Süden findet sich der Laborraum 053. Weiter im Westen ist 3. Westkorridorabschnitt.

>go east
Korridor Abschnitt 2
Der Bereich des Korridors direkt hinter des Eingangsbereichs. Nördlich befindet sich Raum R052 und südlich der Raum R059. Weiter östlich liegt der Korridor Abschnitt 3.

>go east
You can't go that way.

>go north
R052
Ein normales Bürozimmer. Südlich davon befindet sich der Korridor Abschnitt 2.

>go southwest
You can't go that way.

>go southsouthwest
You can't see any such thing.

* * *

>go west
Westkorridor Abschnitt 2
Westkorridor Abschnitt 2. Hier finden sich zwei Räume und ein Labor. Nordöstlich ist der Raum 059 und nordwestlich ist Raum 058. Im Süden findet sich der Laborraum 053. Weiter im Westen ist 3. Westkorridorabschnitt.

>go west
Westkorridor Abschnitt 3
Westkorridor Abschnitt 3. Hier findet sich ein Labor und ein Raum. Im Norden ist der Laborraum 053 und im Süden der Raum 054. Westlich hiervon liegt die Westkorridorecke.

>go west
Westkorridor Ecke
Die Westkorridor Ecke zwischen Abschnitt 3 und 4. Hier befinden sich der Kopierer sowie das Kopieraufladegerät. Südöstlich ist der Laborraum 055 und südwestlich der Laborraum 056. Im Westen befindet sich der Westkorridorabschnitt 3 und nördlich der Abschnitt 4.

>say
I didn't understand that sentence.

>say sad
(to yourself)
There is no reply.

>go east
Westkorridor Abschnitt 3
Westkorridor Abschnitt 3. Hier findet sich ein Labor und ein Raum. Im Norden ist der Laborraum 053 und im Süden der Raum 054. Westlich hiervon liegt die Westkorridorecke.

>go east
Westkorridor Abschnitt 2
Westkorridor Abschnitt 2. Hier finden sich zwei Räume und ein Labor. Nordöstlich ist der Raum 059 und nordwestlich ist Raum 058. Im Süden findet sich der Laborraum 053. Weiter im Westen ist 3. Westkorridorabschnitt.

>go east
Westkorridor Abschnitt 1
Der Eingangsbereich des Ostflügels. Im Norden ist ein Zwischenraum der ins Herren WC und zum Raum 060 führt. Südöstlich der Laborraum 051 und südwestlich der Raum 052. Östlich ist der Westkorridor Abschnitt 2.

>go north
Zwischenraum A
Ein kleiner Zwischenraum. Weiter im Norden ist der Raum 060 und im Osten ist das Herren WC. Im Süden geht zum Westkorridor Abschnitt 1.

You can see Geist here.

* * *

>go south
Westkorridor Abschnitt 1
Der Eingangsbereich des Ostflügels. Im Norden ist ein Zwischenraum der ins Herren WC und zum Raum 060 führt. Südöstlich der Laborraum 051 und südwestlich der Raum 052. Östlich ist der Westkorridor Abschnitt 2.

>say hey
(to Geist)
There is no reply.

buuh.

>go north
Zwischenraum A
Ein kleiner Zwischenraum. Weiter im Norden ist der Raum 060 und im Osten ist das Herren WC. Im Süden geht zum Westkorridor Abschnitt 1.

>say ad
(to Geist)
There is no reply.

buuh.

* * *

>go south
Westkorridor Abschnitt 1
Der Eingangsbereich des Ostflügels. Im Norden ist ein Zwischenraum der ins Herren WC und zum Raum 060 führt. Südöstlich der Laborraum 051 und südwestlich der Raum 052. Östlich ist der Westkorridor Abschnitt 2.

>say b
(to Geist)
There is no reply.

>say b
(to Geist)
There is no reply.

buuh.

>go west
Westkorridor Abschnitt 2
Westkorridor Abschnitt 2. Hier finden sich zwei Räume und ein Labor. Nordöstlich ist der Raum 059 und nordwestlich ist Raum 058. Im Süden findet sich der Laborraum 053. Weiter im Westen ist 3. Westkorridorabschnitt.

* * *

>go west
Westkorridor Abschnitt 3
Westkorridor Abschnitt 3. Hier findet sich ein Labor und ein Raum. Im Norden ist der Laborraum 053 und im Süden der Raum 054. Westlich hiervon liegt die Westkorridorecke.

>say asd
(to Geist)
There is no reply.

>say sad
(to Geist)
There is no reply.

buuh.

>go west
Westkorridor Ecke
Die Westkorridor Ecke zwischen Abschnitt 3 und 4. Hier befinden sich der Kopierer sowie das Kopieraufladegerät. Südöstlich ist der Laborraum 055 und südwestlich der Laborraum 056. Im Westen befindet sich der Westkorridorabschnitt 3 und nördlich der Abschnitt 4.

>say sad
(to Geist)
There is no reply.

>say ad
(to yourself)
There is no reply.

>say asdasd
(to yourself)
There is no reply.

* * *

>go south
Westkorridor Abschnitt 1
Der Eingangsbereich des Ostflügels. Im Norden ist ein Zwischenraum der ins Herren WC und zum Raum 060 führt. Südöstlich der Laborraum 051 und südwestlich der Raum 052. Östlich ist der Westkorridor Abschnitt 2.

>say bruh
(to Geist)
There is no reply.

>say bruh
(to Geist)
There is no reply.

buuh.

>go west
Westkorridor Abschnitt 2
Westkorridor Abschnitt 2. Hier finden sich zwei Räume und ein Labor. Nordöstlich ist der Raum 059 und nordwestlich ist Raum 058. Im Süden findet sich der Laborraum 053. Weiter im Westen ist 3. Westkorridorabschnitt.

* * *

>go west
Westkorridor Ecke
Die Westkorridor Ecke zwischen Abschnitt 3 und 4. Hier befinden sich der Kopierer sowie das Kopieraufladegerät. Südöstlich ist der Laborraum 055 und südwestlich der Laborraum 056. Im Westen befindet sich der Westkorridorabschnitt 3 und nördlich der Abschnitt 4.

>say sd
(to yourself)
There is no reply.

* * *

>go south
Westkorridor Abschnitt 1
Der Eingangsbereich des Ostflügels. Im Norden ist ein Zwischenraum der ins Herren WC und zum Raum 060 führt. Südöstlich der Laborraum 051 und südwestlich der Raum 052. Östlich ist der Westkorridor Abschnitt 2.

>show
(Geist Geist)
(first taking Geist)
I don't suppose Geist would care for that.

>say hello
(to Geist)
There is no reply.

buuh.

>say heloooo
(to Geist)
There is no reply.

>say bro
(to Geist)
There is no reply.

buuh.

* * *

>go north
Zwischenraum A
Ein kleiner Zwischenraum. Weiter im Norden ist der Raum 060 und im Osten ist das Herren WC. Im Süden geht zum Westkorridor Abschnitt 1.

You can see Geist here.

>saay br
That's not a verb I recognise.

>say br
(to Geist)
There is no reply.

1buuh.

* * *

>go north
Zwischenraum A
Ein kleiner Zwischenraum. Weiter im Norden ist der Raum 060 und im Osten ist das Herren WC. Im Süden geht zum Westkorridor Abschnitt 1.

You can see Geist here.

>say hello
(to Geist)
There is no reply.

>say bruh
(to Geist)
There is no reply.

buuh.

>go south
Westkorridor Abschnitt 1
Der Eingangsbereich des Ostflügels. Im Norden ist ein Zwischenraum der ins Herren WC und zum Raum 060 führt. Südöstlich der Laborraum 051 und südwestlich der Raum 052. Östlich ist der Westkorridor Abschnitt 2.

>go east
Ostkorridor 1
Hier ist der Ostkorridor 1. Von hier aus kann man nördlich in die Damentoilette und östlich in den Ostkorridor 2.

>say be
(to Geist)
There is no reply.

buuh.

* * *

>go north
Zwischenraum A
Ein kleiner Zwischenraum. Weiter im Norden ist der Raum 060 und im Osten ist das Herren WC. Im Süden geht zum Westkorridor Abschnitt 1.

You can see Geist here.

>say hello ghost
(to Geist)
There is no reply.

buuh.

>go south
Westkorridor Abschnitt 1
Der Eingangsbereich des Ostflügels. Im Norden ist ein Zwischenraum der ins Herren WC und zum Raum 060 führt. Südöstlich der Laborraum 051 und südwestlich der Raum 052. Östlich ist der Westkorridor Abschnitt 2.

>say hello
(to Geist)
There is no reply.

>say bye
(to Geist)
There is no reply.

buuh.

>go north
Zwischenraum A
Ein kleiner Zwischenraum. Weiter im Norden ist der Raum 060 und im Osten ist das Herren WC. Im Süden geht zum Westkorridor Abschnitt 1.

>say bruh
(to Geist)
There is no reply.

* * *

>say bruh
(to Geist)
There is no reply.

buuh.

>say bruh
(to Geist)
There is no reply.

>go south
Westkorridor Abschnitt 1
Der Eingangsbereich des Ostflügels. Im Norden ist ein Zwischenraum der ins Herren WC und zum Raum 060 führt. Südöstlich der Laborraum 051 und südwestlich der Raum 052. Östlich ist der Westkorridor Abschnitt 2.

>say he
(to Geist)
There is no reply.

>say br
(to Geist)
There is no reply.

buuh.

* * *

>go north
Zwischenraum A
Ein kleiner Zwischenraum. Weiter im Norden ist der Raum 060 und im Osten ist das Herren WC. Im Süden geht zum Westkorridor Abschnitt 1.

You can see Geist here.

>say hey
(to Geist)
There is no reply.

>say ok
(to Geist)
There is no reply.

buuh.

>go south
Westkorridor Abschnitt 1
Der Eingangsbereich des Ostflügels. Im Norden ist ein Zwischenraum der ins Herren WC und zum Raum 060 führt. Südöstlich der Laborraum 051 und südwestlich der Raum 052. Östlich ist der Westkorridor Abschnitt 2.

* * *

>go west
Westkorridor Abschnitt 3
Westkorridor Abschnitt 3. Hier findet sich ein Labor und ein Raum. Im Norden ist der Laborraum 053 und im Süden der Raum 054. Westlich hiervon liegt die Westkorridorecke.

>look at doo
You can't see any such thing.

>look
Westkorridor Abschnitt 3
Westkorridor Abschnitt 3. Hier findet sich ein Labor und ein Raum. Im Norden ist der Laborraum 053 und im Süden der Raum 054. Westlich hiervon liegt die Westkorridorecke.

You can see Geist here.

>see
That's not a verb I recognise.

>look
Westkorridor Abschnitt 3
Westkorridor Abschnitt 3. Hier findet sich ein Labor und ein Raum. Im Norden ist der Laborraum 053 und im Süden der Raum 054. Westlich hiervon liegt die Westkorridorecke.

You can see Geist here.

buuh.

>go north
Raum 057
Ein Labor. Südlich befindet sich der Westkorridor Abschnitt 3.

>go north
You can't go that way.

>go south
Westkorridor Abschnitt 3
Westkorridor Abschnitt 3. Hier findet sich ein Labor und ein Raum. Im Norden ist der Laborraum 053 und im Süden der Raum 054. Westlich hiervon liegt die Westkorridorecke.

>go west
Westkorridor Ecke
Die Westkorridor Ecke zwischen Abschnitt 3 und 4. Hier befinden sich der Kopierer sowie das Kopieraufladegerät. Südöstlich ist der Laborraum 055 und südwestlich der Laborraum 056. Im Westen befindet sich der Westkorridorabschnitt 3 und nördlich der Abschnitt 4.

* * *

Ostfalia
An Interactive Fiction by Fadi Dokmak, Amina Mustafi, Ibrahim Karaki
Release 1 / Serial number 180426 / Inform 7 build 6M62 (I6/v6.33 lib 6/12N) SD

Westkorridor Abschnitt 1
Der Eingangsbereich des Ostflügels. Im Norden ist ein Zwischenraum der ins Herren WC und zum Raum 060 führt. Südöstlich der Laborraum 051 und südwestlich der Raum 052. Östlich ist der Westkorridor Abschnitt 2.

>go south
You can't go that way.

>go east
Korridor Abschnitt 1
Der Eingangsbereich des Ostflügels. Hier befinden sich die Räume R051, R060

>go east
R060
Ein normales Bürozimmer

* * *

Ostfalia
An Interactive Fiction by Fadi Dokmak, Amina Mustafi, Ibrahim Karaki
Release 1 / Serial number 180426 / Inform 7 build 6M62 (I6/v6.33 lib 6/12N) SD

Westkorridor Abschnitt 1
Der Eingangsbereich des Ostflügels. Im Norden ist ein Zwischenraum der ins Herren WC und zum Raum 060 führt. Südöstlich der Laborraum 051 und südwestlich der Raum 052. Östlich ist der Westkorridor Abschnitt 2.

>go southwest
You can't go that way.

>go southeast
R051
Ein Labor. Nördlich befindet sich der Korridor Abschnitt 1.

>go west
R052
Ein normales Bürozimmer. Nördlich befindet sich der Korridor Abschnitt 1.

>go east
R051
Ein Labor. Nördlich befindet sich der Korridor Abschnitt 1.

>go northwest
Korridor Abschnitt 1
Der Eingangsbereich des Ostflügels. Im Norden ist ein Zwischenraum der ins Herren WC und zum Raum 060 führt. Südöstlich der Laborraum 051 und südwestlich der Raum 052. Östlich ist der Korridor Abschnitt 2.

>go west
Korridor Abschnitt 2
Korridor Abschnitt 2. Hier finden sich zwei Räume und ein Labor. Nordöstlich ist der Raum 059 und nordwestlich ist Raum 058. Im Süden findet sich der Laborraum 053. Weiter im Westen ist 3. Korridorabschnitt.

>go south
R053
Ein Labor. Nördlich befindet sich der Korridor Abschnitt 2.

>go north
Korridor Abschnitt 2
Korridor Abschnitt 2. Hier finden sich zwei Räume und ein Labor. Nordöstlich ist der Raum 059 und nordwestlich ist Raum 058. Im Süden findet sich der Laborraum 053. Weiter im Westen ist 3. Korridorabschnitt.

>go northwest
R058
Ein normales Bürozimmer. Südlich befindet sich der Korridor Abschnitt 2.

* * *

Ostfalia
An Interactive Fiction by Fadi Dokmak, Amina Mustafi, Ibrahim Karaki
Release 1 / Serial number 180426 / Inform 7 build 6M62 (I6/v6.33 lib 6/12N) SD

Westkorridor Abschnitt 1
Der Eingangsbereich des Ostflügels. Im Norden ist ein Zwischenraum der ins Herren WC und zum Raum 060 führt. Südöstlich der Laborraum 051 und südwestlich der Raum 052. Östlich ist der Westkorridor Abschnitt 2.

>go west
Westkorridor Abschnitt 2
Westkorridor Abschnitt 2. Hier finden sich zwei Räume und ein Labor. Nordöstlich ist der Raum 059 und nordwestlich ist Raum 058. Im Süden findet sich der Laborraum 053. Weiter im Westen ist 3. Westkorridorabschnitt.

>go east
Korridor Abschnitt 1
Der Eingangsbereich des Ostflügels. Westlich befindet sich Raum R051 und östlich Raum R060.

* * *

>go west
Westkorridor Abschnitt 2
Westkorridor Abschnitt 2. Hier finden sich zwei Räume und ein Labor. Nordöstlich ist der Raum 059 und nordwestlich ist Raum 058. Im Süden findet sich der Laborraum 053. Weiter im Westen ist 3. Westkorridorabschnitt.

>go south
Raum 053
Ein Labor. Nördlich befindet sich der Westkorridor Abschnitt 2.

* * *

>go west
Westkorridor Ecke
Die Westkorridor Ecke zwischen Abschnitt 3 und 4. Hier befinden sich der Kopierer sowie das Kopieraufladegerät. Südöstlich ist der Laborraum 055 und südwestlich der Laborraum 056. Im Westen befindet sich der Westkorridorabschnitt 3 und nördlich der Abschnitt 4.

>go north
Westkorridor Abschnitt 4
Westkorridor Abschnitt 4. HIer findet sich ein Frauen WC sowie ein Raum und ein Labor. Im Osten ist das Frauen WC. Im Nordwestlichen ist der Laborraum 075 und im Südwestlichen der Raum 074. Weiter im Norden ist der 6. Westkorridorabschnitt und im Süden ist die Westkorridorecke.

>go north
Westkorridor Abschnitt 5
Westkorridor Abschnitt 5. Hier befinden sich zwei normale Büros. Westlich liegt der Raum 076 und Östlich der Raum 072. Weiter im Norden geht es zum 6. Westkorridorabschnitt und südlich ist der 4. Abschnitt.

>go north
Westkorridor Abschnitt 6
Westkorridor Abschnitt 6. Hier ist das RoboCup Labor sowie ein weiteres Labor und ein Büro. Im Osten ist das RoboCup Labor, im Südwesten der Raum 077 und im Nordwesten der Laborraum 078. Südlich ist Westkorridor Abschnitt 5 und Nördlich ist der Westkorridor Abschnitt 7.

>go north
Westkorridor Abschnitt 7
Westkorridor Abschnitt 7. Hier befindet sich ein Labor und zwei Büros. Östlich liegt das Labor 085, nordwestlich ein Zwischenraum der zum Raum 080A führt. Südwestlich liegt der Raum 079. Nördlich ist der 8. und letzte Westkorridorabschnitt und südlich ist der 7. Abschnitt.

>go north
Westkorridor Abschnitt 8
Westkorridor Abschnitt 8. Dies ist der nördlichste Teil des Westkorridors des Westflügels. Hier befinden sich vier Büros. Im Südwestlichen ist Raum 081 und im Südöstlichen der Raum 084. Im Nordwestlichen ist der Raum 082 und im Nordöstlichen der Raum 083. Weiter im Süden geht es zum Westkorridorabschnitt 7.

>go notrth
You can't see any such thing.

>go north
You can't go that way.

>go south
Westkorridor Abschnitt 7
Westkorridor Abschnitt 7. Hier befindet sich ein Labor und zwei Büros. Östlich liegt das Labor 085, nordwestlich ein Zwischenraum der zum Raum 080A führt. Südwestlich liegt der Raum 079. Nördlich ist der 8. und letzte Westkorridorabschnitt und südlich ist der 7. Abschnitt.

* * *

Ostfalia
An Interactive Fiction by Fadi Dokmak, Amina Mustafi, Ibrahim Karaki
Release 1 / Serial number 180426 / Inform 7 build 6M62 (I6/v6.33 lib 6/12N) SD

Westkorridor Abschnitt 1
Der Eingangsbereich des Ostflügels. Im Norden ist ein Zwischenraum der ins Herren WC und zum Raum 060 führt. Südöstlich der Laborraum 051 und südwestlich der Raum 052. Östlich ist der Westkorridor Abschnitt 2.

>show
(yourself yourself)
(first taking yourself)
You are always self-possessed.

>go southeast
R051
Ein Labor. Nördlich befindet sich der Korridor Abschnitt 1.

>go north
You can't go that way.

>go northwest
Korridor Abschnitt 1
Der Eingangsbereich des Ostflügels. Im Norden ist ein Zwischenraum der ins Herren WC und zum Raum 060 führt. Südöstlich der Laborraum 051 und südwestlich der Raum 052. Östlich ist der Korridor Abschnitt 2.

>go southwest
You can't go that way.